                  #
                  #
        ----------+----------
        I                   I
        I       Exit        I
        I                   I
        ---------------------

